2222222222
2400040042
2000000002
2000000002
2222202222
2000030002
2000000002
2030000302
2000100002
2222222222